1111111111111
10010E0000001
10C0011111001
1000110000001
1111111111111
