1111111111111
10010E0000001
10C0011111001
1000110000010
1111111111111
