1111111111111
10E100E00E0C1
10000C0000001
1E0P0111110C1
1C010C0010001
10E011E0C00E1
1111111111111
