1111111111111
10010E0000001
10C0011111001
10001100P001
1111111111111
