1111111111111
1001000000001
10000111110P1
10001100000E1
1111111111111
