1111111111111
10010E0000001
10C0011111001
100011000001
1111111111111
