1111111111111
1001000000001
10C00111110P1
1000110000001
1111111111111
