1111111111111
10010000000C1
10000111110P1
10001100000E1
1111111111111