1111111111111
1C00100000001
1P00001111101
1E00011000001
1111111111111
