1111111111111
10E100E00E0C1
1E000111110P1
10E011E0000E1
1111111111111